⠀⠀⠀⠀⠀⠀⠀⠀⠀⠀⠀⠀⠀⠀⠀⠀⠀⠀⠀⠀⠀⠀⠀⠀⠀⠀⠀⠀⠀⠀⠀⠀⠀⠀⠀⠀⠀⠀⠀⠀
⠀⠀⠀⢠⣤⣤⣀⣤⡄⠀⠀⠀⠀⠀⠀⠀⠀⠀⠀⠀⠀⠀⠀⠀⠀⠀⠀⠀⠀⠀⠀⠀⠀⠀⠀⠀⠀⠀⠀⠀
⠀⠀⠀⢘⣿⣿⣿⣿⠃⠀⠀⠀⠀⠀⠀⠀⠀⠀⠀⠀⠀⠀⠀⠀⠀⠀⠀⠀⠀⠀⠀⠀⠀⠀⠀⠀⠀⠀⠀⠀
⠀⠀⠀⢰⣿⣿⣿⣿⡆⠀⠀⠀⠀⠀⠀⠀⠀⠀⠀⠀⠀⠀⠀⠀⠀⠀⠀⠀⠀⠀⠀⠀⠀⠀⠀⠀⠀⠀⠀⠀
⠀⠀⠀⠈⠉⠁⠉⠩⠁⠀⠀⠀⠀⠀⠀⠀⠀⠀⠀⠀⠀⠀⠀⠀⠀⠀⠀⠀⠀⠀⠀⠀⠀⠀⠀⠀⠀⠀⠀⠀
⠀⠀⠀⠀⠀⠀⠀⠀⠀⠀⠀⠀⠀⠀⠀⠀⠀⠀⠀⠀⠀⠀⠀⠀⠀⠀⠀⠀⠀⠀⠀⠀⠀⠀⠀⠀⠀⠀⠀⠀
⠀⠀⠀⢀⣠⣀⣀⡄⢀⠀⢀⢀⠀⢀⢀⠀⢀⠀⠀⡀⣀⣀⣂⡀⡀⠀⡀⠀⠀⠀⠀⠀⠀⠀⠀⠀⠀⠀⠀⠀
⠀⠀⠀⣿⣿⣿⣿⣷⣶⣶⣶⣶⣶⣶⣶⣶⣶⣶⣶⣶⣾⣿⣿⣶⣶⣶⣾⣿⡇⡀⠀⠀⠀⠀⠀⠀⠀⠀⠀⠀
⠀⠀⠀⢿⣿⣿⣿⣿⣿⣿⣿⣿⣿⣿⣿⣿⣿⣿⣿⣿⣿⣿⣿⣿⣿⣿⣿⣿⣷⠀⠀⠀⠀⠀⠀⠀⠀⠀⠀⠀
⠀⠀⠀⢀⣀⣂⣀⣀⣀⣈⣋⣑⣈⡋⠃⠀⠐⠐⠀⠂⠐⠀⠂⠐⠈⠙⠛⠋⠁⠀⠀⠀⠀⠀⠀⠀⠀⠀⠀⠀
⠀⠀⠀⣿⣿⢿⣿⣿⣿⣿⣿⣿⣿⡏⠄⠀⠀⠀⠀⠀⠀⠀⠀⠀⠀⠀⠀⠀⠀⠀⠀⠀⠀⠀⠀⠀⠀⠀⠀⠀
⠀⠀⠀⠛⠛⠛⠛⠛⠛⠛⠛⠛⠛⠁⠀⠀⠀⠀⠀⠀⠀⠀⠀⠀⠀⠀⠀⠀⠀⠀⠀⠀⠀⠀⠀⠀⠀⠀⠀⠀
⠀⠀⠀⠀⠀⠀⠀⠀⠀⠀⠀⠀⠀⠀⠀⠀⠀⠀⠀⠀⠀⠀⠀⠀⠀⠀⠀⠀⠀⠀⠀⠀⠀⠀⠀⠀⠀⠀⠀⠀
⠀⠀⠀⢀⣀⣀⣤⣄⢀⣐⣀⣀⣀⣀⣀⡀⠀⡀⠀⠀⠀⠀⠀⠀⠀⠀⠀⠀⠀⠀⠀⠀⠀⠀⠀⠀⠀⠀⠀⠀
⠀⠀⠐⣾⣿⣿⣿⣿⣿⣿⣿⣿⣿⣿⣿⣿⣿⣿⡆⠀⠀⠀⠀⠀⠀⠀⠀⠀⠀⠀⠀⠀⠀⠀⠀⠀⠀⠀⠀⠀
⠀⠀⠀⠉⠍⣍⡩⣉⣉⣉⢍⣍⡩⣩⣉⣛⢛⣉⡁⣀⣀⣀⣀⣀⣀⣀⣀⣀⣀⣀⣀⣀⡀⡀⠀⠀⠀⠀⠀⠀
⠀⠀⠀⡰⡩⠒⠒⠒⠒⠒⣶⣶⣶⣶⣶⣲⣒⣒⣖⣲⣶⣶⣶⣖⣒⣢⣶⣒⠂⠒⠒⠔⠪⢪⢢⠀⠀⠀⠀⠀
⠀⠀⠀⢣⢣⣀⣀⣀⣀⣀⢿⣿⡿⡿⡿⣿⢿⠿⡿⡿⡿⡿⡿⡿⡿⣿⡿⣿⣀⣀⣀⣀⣀⢜⡸⠀⠀⠀⠀⠀
⠀⠀⠀⠀⣑⡢⢖⠦⡲⢲⠲⡲⠲⡲⡲⡲⢲⠲⡲⡲⡲⡲⢲⠲⡲⢲⠲⡢⢖⠦⡲⡢⢖⣑⠀⠀⠀⠀⠀⠀
⠀⠀⠀⡜⡕⠉⠑⠉⠊⠃⠙⣼⣿⣾⣷⣭⣧⣯⣵⣵⣽⣾⣷⣽⣼⣵⣭⡍⠑⠉⠊⠉⠑⢪⢳⠀⠀⠀⠀⠀
⠀⠀⠀⢣⡳⠤⠤⠤⠤⠤⠤⠿⠿⠟⠻⠿⠿⠻⠿⡻⠿⠻⠻⠻⠿⠟⠿⠧⠤⠤⠤⠤⠤⣚⡜⠀⠀⠀⠀⠀
⠀⠀⠀⠀⠈⢉⢉⢉⢉⢉⢉⢉⢉⢉⢉⢉⢉⢽⣿⣿⣯⢉⠍⡉⡉⡉⡉⡉⡉⡉⡉⡉⡉⠅⠀⠀⠀⠀⠀⠀
⠀⠀⠀⢠⣴⣶⣷⣶⣷⣶⣷⣶⣷⣶⣷⣶⣷⣿⣿⣯⣿⣶⣶⣶⣾⣶⣾⣶⣾⣶⣾⣶⣶⣦⣄⠀⠀⠀⠀⠀
⠀⠀⠔⣿⡿⡝⣎⢧⡳⡹⣜⢎⢧⡳⡝⡮⣞⡼⣮⢾⣜⢵⢝⢎⡗⡵⡝⡮⣪⡳⡹⣪⡫⣿⣿⠐⠀⠀⠀⠀
⠀⠀⠁⠻⣿⣿⣾⣾⣮⣯⣮⣷⣷⣷⣽⣮⣷⣿⣽⣿⣾⣾⣮⣷⣽⣾⣮⣷⣷⣽⣾⣾⣾⣿⠟⠀⠀⠀⠀⠀
⠀⠀⠀⣶⣶⣶⣶⣶⣶⣶⣶⣶⣶⣶⣶⣶⣶⣶⣶⣶⣶⣶⣶⣶⣶⣶⣶⣶⣶⣶⣶⣶⣦⠀⠀⠀⠀⠀⠀⠀