⠀⠀⠀⠀⠀⠀⠀⠀⠀⠀⠀⠀⠀⠀⠀⠀⠀⠀⠀⠀⠀⠀⠀⠀⠀⠀⠀⠀⠀⠀⠀⠀⠀⠀⠀⠀⠀⠀⠀⠀⠀⠀⠀⠀⠀⠀⠀⠀⠀⠀⠀⠀⠀⠀⠀⠀⠀⠀⠀⠀⠀⠀⠀⠀⠀⠀⠀⠀⠀⠀⠀⠀⠀⠀⠀⠀⠀⠀⠀⠀
⠀⠀⠀⠀⠀⠀⠀⠀⠀⠀⠀⠀⠀⠀⠀⠀⠀⠀⠀⠀⠀⠀⠀⠀⠀⠀⠀⠀⠀⠀⠀⠀⠀⠀⠀⠀⠀⠀⠀⠀⠀⠀⠀⠀⠀⠀⠀⠀⠀⠀⠀⠀⠀⠀⠀⠀⠀⠀⠀⠀⠀⠀⠀⠀⠀⠀⠀⠀⠀⠀⠀⠀⠀⠀⠀⠀⠀⠀⠀⠀
⠀⠀⠀⠀⠀⠀⠀⠀⠀⠀⠀⠀⠀⠀⠀⠀⠀⠀⠀⠀⠀⠀⠀⠀⠀⠀⠀⠀⠀⠀⠀⠀⠀⠀⠀⠀⠀⠀⠀⠀⠀⠀⠀⠀⠀⠀⠀⠀⠀⠀⠀⠀⠀⠀⠀⠀⠀⠀⠀⠀⠀⠀⠀⠀⠀⠀⠀⠀⠀⠀⠀⠀⠀⠀⠀⠀⠀⠀⠀⠀
⠀⠀⠀⠀⠀⠀⠀⢀⣀⣂⣀⡀⠀⢀⣀⣄⠀⠀⠀⠀⠀⠀⠀⠀⠀⠀⠀⠀⠀⠀⠀⠀⠀⠀⠀⠀⠀⠀⠀⠀⠀⠀⠀⠀⠀⠀⠀⠀⠀⠀⠀⠀⠀⠀⠀⠀⠀⠀⠀⠀⠀⠀⠀⠀⠀⠀⠀⠀⠀⠀⠀⠀⠀⠀⠀⠀⠀⠀⠀⠀
⠀⠀⠀⠀⠀⠀⠀⠘⣿⣿⣿⣿⣬⣾⣿⡿⠀⠀⠀⠀⠀⠀⠀⠀⠀⠀⠀⠀⠀⠀⠀⠀⠀⠀⠀⠀⠀⠀⠀⠀⠀⠀⠀⠀⠀⠀⠀⠀⠀⠀⠀⠀⠀⠀⠀⠀⠀⠀⠀⠀⠀⠀⠀⠀⠀⠀⠀⠀⠀⠀⠀⠀⠀⠀⠀⠀⠀⠀⠀⠀
⠀⠀⠀⠀⠀⠀⠀⠀⠘⢻⣿⣿⣿⣿⡫⠈⠀⠀⠀⠀⠀⠀⠀⠀⠀⠀⠀⠀⠀⠀⠀⠀⠀⠀⠀⠀⠀⠀⠀⠀⠀⠀⠀⠀⠀⠀⠀⠀⠀⠀⠀⠀⠀⠀⠀⠀⠀⠀⠀⠀⠀⠀⠀⠀⠀⠀⠀⠀⠀⠀⠀⠀⠀⠀⠀⠀⠀⠀⠀⠀
⠀⠀⠀⠀⠀⠀⠀⠀⢠⣵⣿⣿⣿⣿⣷⡤⠀⠀⠀⠀⠀⠀⠀⠀⠀⠀⠀⠀⠀⠀⠀⠀⠀⠀⠀⠀⠀⠀⠀⠀⠀⠀⠀⠀⠀⠀⠀⠀⠀⠀⠀⠀⠀⠀⠀⠀⠀⠀⠀⠀⠀⠀⠀⠀⠀⠀⠀⠀⠀⠀⠀⠀⠀⠀⠀⠀⠀⠀⠀⠀
⠀⠀⠀⠀⠀⠀⠀⢰⣿⣿⡟⠝⢿⣿⣿⣿⡆⠀⠀⠀⠀⠀⠀⠀⠀⠀⠀⠀⠀⠀⠀⠀⠀⠀⠀⠀⠀⠀⠀⠀⠀⠀⠀⠀⠀⠀⠀⠀⠀⠀⠀⠀⠀⠀⠀⠀⠀⠀⠀⠀⠀⠀⠀⠀⠀⠀⠀⠀⠀⠀⠀⠀⠀⠀⠀⠀⠀⠀⠀⠀
⠀⠀⠀⠀⠀⠀⠀⠈⠉⠁⠀⠀⠀⠉⠉⠉⠁⠀⠀⠀⠀⠀⠀⠀⠀⠀⠀⠀⠀⠀⠀⠀⠀⠀⠀⠀⠀⠀⠀⠀⠀⠀⠀⠀⠀⠀⠀⠀⠀⠀⠀⠀⠀⠀⠀⠀⠀⠀⠀⠀⠀⠀⠀⠀⠀⠀⠀⠀⠀⠀⠀⠀⠀⠀⠀⠀⠀⠀⠀⠀
⠀⠀⠀⠀⠀⠀⠀⠀⠀⠀⠀⠀⠀⠀⠀⠀⠀⠀⠀⠀⠀⠀⠀⠀⠀⠀⠀⠀⠀⠀⠀⠀⠀⠀⠀⠀⠀⠀⠀⠀⠀⠀⠀⠀⠀⠀⠀⠀⠀⠀⠀⠀⠀⠀⠀⠀⠀⠀⠀⠀⠀⠀⠀⠀⠀⠀⠀⠀⠀⠀⠀⠀⠀⠀⠀⠀⠀⠀⠀⠀
⠀⠀⠀⠀⠀⠀⠀⠀⠀⠀⠀⠀⠀⠀⠀⠀⠀⠀⠀⠀⠀⠀⠀⠀⠀⠀⠀⠀⠀⠀⠀⠀⠀⠀⠀⠀⠀⠀⠀⠀⠀⠀⠀⠀⠀⠀⠀⠀⠀⠀⠀⠀⠀⠀⠀⠀⠀⠀⠀⠀⠀⠀⠀⠀⠀⠀⠀⠀⠀⠀⠀⠀⠀⠀⠀⠀⠀⠀⠀⠀
⠀⠀⠀⠀⠀⠀⠀⠀⠀⠀⠀⠀⠀⠀⠀⠀⠀⠀⠀⠀⠀⠀⠀⠀⠀⠀⠀⠀⠀⠀⠀⠀⠀⠀⠀⠀⠀⠀⠀⠀⠀⠀⠀⠀⠀⠀⠀⠀⠀⠀⠀⠀⠀⠀⠀⠀⠀⠀⠀⠀⠀⠀⠀⠀⠀⠀⠀⠀⠀⠀⠀⠀⠀⠀⠀⠀⠀⠀⠀⠀
⠀⠀⠀⠀⠀⠀⠀⠀⠀⠀⠀⠀⠀⠀⠀⠀⠀⠀⠀⠀⠀⠀⠀⠀⠀⠀⠀⠀⠀⠀⠀⠀⠀⠀⠀⠀⠀⠀⠀⠀⠀⠀⠀⠀⠀⠀⠀⠀⠀⠀⠀⠀⠀⠀⠀⠀⠀⠀⠀⠀⠀⠀⠀⠀⠀⠀⠀⠀⠀⠀⠀⠀⠀⠀⠀⠀⠀⠀⠀⠀
⠀⠀⠀⠀⠀⠀⠀⠀⡀⡀⠀⠀⢀⢀⠀⠀⠀⠀⠀⠀⠀⠀⠀⠀⠀⠀⠀⠀⠀⠀⠀⠀⠀⠀⠀⠀⠀⠀⠀⠀⠀⠀⠀⠀⠀⠀⠀⠀⠀⠀⠀⠀⠀⠀⠀⠀⠀⠀⠀⠀⠀⠀⠀⠀⠀⠀⠀⠀⠀⠀⠀⠀⠀⠀⠀⠀⠀⠀⠀⠀
⠀⠀⠀⠀⠀⠀⠀⣶⣶⣶⣆⢴⣶⣶⡆⡀⠠⠠⠀⠀⠀⠀⠀⠄⢀⠀⠀⠀⠠⠀⠀⠀⠀⠠⠀⠀⠀⠀⠀⠀⠄⡀⣶⣾⣶⡄⠀⠀⠠⠀⠀⠀⠠⠀⣀⣠⡀⠀⠀⠀⠀⠀⠀⠀⠀⠀⠀⠀⠀⠀⠀⠀⠀⠀⠀⠀⠀⠀⠀⠀
⠀⠀⠀⠀⠀⠀⠀⣿⣿⣿⣷⣽⡿⣿⣷⣾⣿⣿⣿⣾⣿⣿⣿⣿⣿⣾⣿⣿⣿⣿⣷⣶⣾⣿⣿⣿⣾⣿⣿⣿⣿⣷⣿⣿⣿⣾⣿⣿⣿⣿⣶⣾⣿⣿⣿⣿⡇⠀⠀⠀⠀⠀⠀⠀⠀⠀⠀⠀⠀⠀⠀⠀⠀⠀⠀⠀⠀⠀⠀⠀
⠀⠀⠀⠀⠀⠀⠀⣿⣿⣾⡿⢿⣯⣾⢿⣿⣿⣿⣝⡧⣟⣽⣿⣿⢯⣟⣯⣿⣿⣿⢿⣿⣻⣿⢿⣿⣿⣯⣿⣿⣿⣿⣿⣟⣿⣿⣿⡟⣿⣯⣿⣿⡻⣾⣿⣿⡇⠀⠀⠀⠀⠀⠀⠀⠀⠀⠀⠀⠀⠀⠀⠀⠀⠀⠀⠀⠀⠀⠀⠀
⠀⠀⠀⠀⠀⠀⠀⢿⣿⣿⠯⢹⣿⣿⡿⣷⣿⣿⣾⣷⣿⣺⣿⣿⣿⣿⣿⣾⣿⣿⡿⠿⢿⣿⣿⣿⢿⣿⣿⠗⣿⣿⣿⣿⣿⣿⣿⡇⣿⣷⣷⣿⣼⢮⣿⣿⣿⠀⠀⠀⠀⠀⠀⠀⠀⠀⠀⠀⠀⠀⠀⠀⠀⠀⠀⠀⠀⠀⠀⠀
⠀⠀⠀⠀⠀⠀⠀⠀⠀⠀⠀⠀⠀⠀⠀⠀⠂⠀⠐⠸⠿⠿⠇⠂⠀⠻⠿⠿⠃⠂⠀⠀⠀⠐⠀⠀⠀⠀⠀⠀⠀⠀⠀⠀⠀⠀⠀⠀⠀⠐⠻⠿⠿⠿⠿⠟⠃⠀⠀⠀⠀⠀⠀⠀⠀⠀⠀⠀⠀⠀⠀⠀⠀⠀⠀⠀⠀⠀⠀⠀
⠀⠀⠀⠀⠀⠀⠀⠀⠀⠀⠀⡀⠀⠀⠀⢀⠀⠀⠀⠀⠈⠀⠀⠀⠀⠀⠈⠀⠀⠀⠀⠀⠀⠀⠀⠀⠀⠀⠀⠀⠀⠀⠀⠀⠀⠀⠀⠀⠀⠀⠀⠈⠈⠈⠈⠀⠀⠀⠀⠀⠀⠀⠀⠀⠀⠀⠀⠀⠀⠀⠀⠀⠀⠀⠀⠀⠀⠀⠀⠀
⠀⠀⠀⠀⠀⠀⠀⣴⣶⣶⣶⣶⣦⣠⣴⣶⣶⣮⣶⣶⣦⣶⣶⣦⣶⣶⣦⠀⠀⠀⠀⠀⠀⠀⠀⠀⠀⠀⠀⠀⠀⠀⠀⠀⠀⠀⠀⠀⠀⠀⠀⠀⠀⠀⠀⠀⠀⠀⠀⠀⠀⠀⠀⠀⠀⠀⠀⠀⠀⠀⠀⠀⠀⠀⠀⠀⠀⠀⠀⠀
⠀⠀⠀⠀⠀⠀⠂⣿⣿⣿⣿⣟⣿⣿⣿⣿⣿⣿⣟⣿⣿⣿⣽⣿⣿⣿⢇⠁⠀⠀⠀⠀⠀⠀⠀⠀⠀⠀⠀⠀⠀⠀⠀⠀⠀⠀⠀⠀⠀⠀⠀⠀⠀⠀⠀⠀⠀⠀⠀⠀⠀⠀⠀⠀⠀⠀⠀⠀⠀⠀⠀⠀⠀⠀⠀⠀⠀⠀⠀⠀
⠀⠀⠀⠀⠀⠀⠂⣿⣿⣿⢿⣿⣾⣿⣿⣿⣿⣿⡿⣿⣾⣾⣿⣷⣿⡿⠐⠀⠀⠀⠀⠀⠀⠀⠀⠀⠀⠀⠀⠀⠀⠀⠀⠀⠀⠀⠀⠀⠀⠀⠀⠀⠀⠀⠀⠀⠀⠀⠀⠀⠀⠀⠀⠀⠀⠀⠀⠀⠀⠀⠀⠀⠀⠀⠀⠀⠀⠀⠀⠀
⠀⠀⠀⠀⠀⠀⠀⠈⠉⠉⠈⠩⠉⠁⠉⠍⠍⠁⠀⠈⠉⠉⠈⠉⠍⠁⠀⠀⠀⠀⠀⠀⠀⠀⠀⠀⠀⠀⠀⠀⠀⠀⠀⠀⠀⠀⠀⠀⠀⠀⠀⠀⠀⠀⠀⠀⠀⠀⠀⠀⠀⠀⠀⠀⠀⠀⠀⠀⠀⠀⠀⠀⠀⠀⠀⠀⠀⠀⠀⠀
⠀⠀⠀⠀⠀⠀⠀⠀⠀⠀⠀⠀⠀⠀⠀⠀⠀⠀⠀⠀⠀⠀⠀⠀⠀⠀⠀⠀⠀⠀⠀⠀⠀⠀⠀⠀⠀⠀⠀⠀⠀⠀⠀⠀⠀⠀⠀⠀⠀⠀⠀⠀⠀⠀⠀⠀⠀⠀⠀⠀⠀⠀⠀⠀⠀⠀⠀⠀⠀⠀⠀⠀⠀⠀⠀⠀⠀⠀⠀⠀
⠀⠀⠀⠀⠀⠀⠀⠀⠀⠀⠀⠀⠀⠀⠀⠀⠀⠀⠀⠀⠀⠀⠀⠀⠀⠀⠀⠀⠀⠀⠀⠀⠀⠀⠀⠀⠀⠀⠀⠀⠀⠀⠀⠀⠀⠀⠀⠀⠀⠀⠀⠀⠀⠀⠀⠀⠀⠀⠀⠀⠀⠀⠀⠀⠀⠀⠀⠀⠀⠀⠀⠀⠀⠀⠀⠀⠀⠀⠀⠀
⠀⠀⠀⠀⠀⠀⠀⠀⠀⠀⠀⠀⠀⠀⠀⠀⠀⠀⠀⠀⠀⠀⠀⠀⠀⠀⠀⠀⠀⠀⠀⠀⠀⠀⠀⠀⠀⠀⠀⠀⠀⠀⠀⠀⠀⠀⠀⠀⠀⠀⠀⠀⠀⠀⠀⠀⠀⠀⠀⠀⠀⠀⠀⠀⠀⠀⠀⠀⠀⠀⠀⠀⠀⠀⠀⠀⠀⠀⠀⠀
⠀⠀⠀⠀⠀⠀⠀⠀⢀⠀⠀⠀⠀⢀⠀⠀⠀⠀⠀⠀⠀⠀⠀⠀⠀⠀⠀⡀⠀⠀⠀⠀⠀⠀⠀⠀⠀⠀⠀⠀⠀⠀⠀⠀⠀⠀⠀⠀⠀⠀⠀⠀⠀⠀⠀⠀⠀⠀⠀⠀⠀⠀⠀⠀⠀⠀⠀⠀⠀⠀⠀⠀⠀⠀⠀⠀⠀⠀⠀⠀
⠀⠀⠀⠀⠀⠀⢀⢰⣶⣶⣂⣂⣲⣶⣶⣂⣂⣂⢀⣴⣴⣆⣂⣂⣂⣂⣶⣶⣖⣐⣐⣐⣀⣐⣀⠀⠀⠀⠀⠀⠀⠀⠀⠀⠀⠀⠀⠀⠀⠀⠀⠀⠀⠀⠀⠀⠀⠀⠀⠀⠀⠀⠀⠀⠀⠀⠀⠀⠀⠀⠀⠀⠀⠀⠀⠀⠀⠀⠀⠀
⠀⠀⠀⠀⠀⠀⢠⣾⣿⣿⣿⣿⣿⣿⣻⣿⣿⣿⠸⣿⣿⣿⣿⣿⣿⣿⣿⣿⣿⡿⣿⣿⣿⣿⣿⣬⢀⠀⠀⠀⠀⠀⠀⠀⠀⠀⠀⠀⠀⠀⠀⠀⠀⠀⠀⠀⠀⠀⠀⠀⠀⠀⠀⠀⠀⠀⠀⠀⠀⠀⠀⠀⠀⠀⠀⠀⠀⠀⠀⠀
⠀⠀⠀⠀⠀⠀⠘⠿⠿⠟⠿⠿⠿⠿⠿⠿⠿⠿⠁⠻⠿⠿⠿⠿⠟⠿⠿⠿⠿⠿⢿⣿⣿⡿⠿⠿⠀⠀⠀⠀⠀⠀⠀⠀⠀⠀⠀⠀⠀⠀⠀⠀⠀⠀⠀⠀⠀⠀⠀⠀⠀⠀⠀⠀⠀⠀⠀⠀⠀⠀⠀⠀⠀⠀⠀⠀⠀⠀⠀⠀
⠀⠀⠀⠀⠀⠀⠀⠈⠀⠀⠀⠁⠀⠀⠀⠀⠀⠀⠀⠀⠀⠀⠀⠁⠀⠈⠀⠀⠀⠁⠈⠉⠉⠀⠀⠀⠀⠀⠀⠀⠀⠀⠀⠀⠀⠀⠀⠀⠀⠀⠀⠀⠀⠀⠀⠀⠀⠀⠀⠀⠀⠀⠀⠀⠀⠀⠀⠀⠀⠀⠀⠀⠀⠀⠀⠀⠀⠀⠀⠀
⠀⠀⠀⠀⠀⠀⠀⠀⠀⣀⣤⣤⣤⣤⣤⣤⣤⣤⣤⣤⣤⣤⣤⣤⣤⣤⣤⣤⣤⣤⣤⡤⣤⡤⣤⣤⣤⣤⣤⣤⣤⣤⣤⣤⣤⣤⣤⣤⣤⣤⣤⣤⣤⣤⣤⣤⣤⣤⣤⣤⣤⣤⣤⣤⣤⣤⣀⡀⠀⠀⠀⠀⠀⠀⠀⠀⠀⠀⠀⠀
⠀⠀⠀⠀⠀⠀⠀⣠⢾⠽⠚⠚⠑⠛⠚⠑⠛⠚⠓⠛⠚⢓⣙⣚⣑⠛⠚⠓⠛⠚⠓⠛⠙⠙⠛⠚⠓⠛⠚⠓⠋⠚⠓⠋⠚⠓⠛⠚⠓⠛⠚⠓⠛⠚⠓⠛⠚⠓⠛⠚⠓⠛⠚⠓⠙⠚⠺⣝⣦⠀⠀⠀⠀⠀⠀⠀⠀⠀⠀⠀
⠀⠀⠀⠀⠀⠀⢠⣯⡏⠀⠀⠀⠀⠀⠀⠀⠀⠀⠀⠀⠀⣿⣿⣿⣿⣦⣺⣿⣿⣿⣶⣶⣶⣶⣶⣶⣶⣶⣶⣶⣿⣿⣿⣷⣶⣿⣿⣶⣶⣶⣶⣶⣿⣷⣶⡄⠀⠀⠀⠀⠀⠀⠀⠀⠀⠀⠀⠘⡞⡇⠀⠀⠀⠀⠀⠀⠀⠀⠀⠀
⠀⠀⠀⠀⠀⠀⠈⣗⣇⠀⠀⠀⠀⠀⠀⠀⠀⠀⠀⠀⠀⢿⣿⣿⣿⡟⠻⣿⡿⣿⣿⡿⠿⠿⣿⣿⣿⠿⠿⠿⠿⢿⠾⠿⠿⣿⡿⣿⠿⣿⣿⣿⣿⢿⡿⠇⠀⠀⠀⠀⠀⠀⠀⠀⠀⠀⠀⢠⢯⡇⠀⠀⠀⠀⠀⠀⠀⠀⠀⠀
⠀⠀⠀⠀⠀⠀⠀⠙⢮⣳⠦⡤⡤⡤⡤⡤⡤⡤⡤⡤⡤⡤⡭⡭⡭⡤⡤⡤⡤⡭⡭⡤⡤⡤⡤⡥⡥⡤⡤⡤⡤⡤⡤⡤⡤⡤⡤⡤⡤⡤⡬⡭⡥⡤⡤⡤⡤⡤⡤⡤⡤⡤⡤⡤⡤⢤⣞⡯⠏⠀⠀⠀⠀⠀⠀⠀⠀⠀⠀⠀
⠀⠀⠀⠀⠀⠀⠀⠀⠀⠈⠉⠙⠙⠙⠙⠙⠙⠙⠙⠙⠙⠙⠙⠙⠙⠙⠙⠙⠙⠙⠙⠙⠙⠙⠙⠙⠙⠙⠙⠙⠙⠙⠙⠙⠙⠙⠙⠙⠙⠙⠙⠙⠙⠙⠙⠙⠙⠙⠙⠙⠙⠙⠙⠙⠙⠉⠁⠀⠀⠀⠀⠀⠀⠀⠀⠀⠀⠀⠀⠀
⠀⠀⠀⠀⠀⠀⠀⠀⣠⡴⣶⣲⣲⣲⣲⣲⣲⣲⣲⣲⣲⣲⣲⣒⣖⣲⣲⣲⣲⣲⣲⣲⣲⣲⣲⣲⣲⣲⣲⣲⣲⣲⣲⣲⣲⣲⣲⣲⣲⣲⣲⣲⣲⣲⣲⣲⣲⣲⣲⣲⣲⣲⣲⣲⣲⣲⡦⣄⡀⠀⠀⠀⠀⠀⠀⠀⠀⠀⠀⠀
⠀⠀⠀⠀⠀⠀⠀⡼⣷⠛⠉⠀⠀⠀⠀⠀⠀⠀⠀⠀⠀⠀⠀⣐⣴⣶⡀⣐⣐⣀⡠⠠⠠⠀⠀⠀⠠⠠⠀⠀⢀⣐⣀⣀⡄⢀⣀⡀⠄⠠⢠⣀⡠⠀⠀⠀⠀⠀⠀⠀⠀⠀⠀⠀⠀⠉⠙⢯⣳⡄⠀⠀⠀⠀⠀⠀⠀⠀⠀⠀
⠀⠀⠀⠀⠀⠀⢸⡿⡇⠀⠀⠀⠀⠀⠀⠀⠀⠀⠀⠀⠀⠠⢹⣿⣿⣿⣏⣿⣿⣿⣿⣿⣿⣿⣿⣿⣿⣿⣿⣿⣿⣿⣿⣿⣿⣾⣿⣿⣿⣿⣿⣿⣿⣿⡆⠀⠀⠀⠀⠀⠀⠀⠀⠀⠀⠀⠀⠈⣗⡇⠀⠀⠀⠀⠀⠀⠀⠀⠀⠀
⠀⠀⠀⠀⠀⠀⠀⢯⣷⣀⠀⠀⠀⠀⠀⠀⠀⠀⠀⠀⠀⠈⠸⣿⣿⣿⠟⠻⠿⠿⣿⣿⠿⠻⠻⠿⡿⡿⠛⠛⠛⠟⠿⠟⠟⠻⠛⢿⠿⣿⠿⠻⠿⠿⠃⠀⠀⠀⠀⠀⠀⠀⠀⠀⠀⠀⢀⣼⣳⠇⠀⠀⠀⠀⠀⠀⠀⠀⠀⠀
⠀⠀⠀⠀⠀⠀⠀⠈⠛⢯⣟⣖⣖⣖⣖⣖⣖⣖⣖⣖⣖⣖⣖⣖⣲⣒⣖⣖⣖⣖⣲⣒⣖⣖⣖⣖⣲⣒⣖⣖⣖⣖⣖⣖⣖⣖⣖⣖⣲⣲⣲⣲⣲⣲⣲⣲⣲⣲⣲⣲⣲⣲⣲⣲⣲⣻⡯⠟⠁⠀⠀⠀⠀⠀⠀⠀⠀⠀⠀⠀
⠀⠀⠀⠀⠀⠀⠀⠀⠀⠀⠀⠀⠀⠀⠀⠀⠀⠀⠀⠀⠀⠀⠀⠀⠀⠀⠀⠀⠀⠀⠀⠀⠀⠀⠀⢀⣠⣤⣤⣤⣀⠀⠀⠀⠀⠀⠀⠀⠀⠀⠀⠀⠀⠀⠀⠀⠀⠀⠀⠀⠀⠀⠀⠀⠀⠀⠀⠀⠀⠀⠀⠀⠀⠀⠀⠀⠀⠀⠀⠀
⠀⠀⠀⠀⠀⠀⠀⢔⢊⣒⡘⡔⣂⡣⣒⡘⡔⣂⡣⣒⡘⡔⣂⡣⣒⡘⡔⣂⡣⣒⡘⡔⣂⡣⡂⢸⣿⣿⣿⣽⣿⠀⣒⢜⣐⢢⢃⡒⡜⣐⢢⢃⡒⡜⣐⢢⢃⡒⡜⣐⢢⢃⡒⡜⣐⢢⢃⡪⡢⠀⠀⠀⠀⠀⠀⠀⠀⠀⠀⠀
⠀⠀⠀⠀⠀⠀⠀⠀⠀⠀⠄⠠⠀⠠⠀⠠⠀⠄⠀⠄⠠⠀⠄⠀⠄⠠⠀⠄⠀⠄⠠⠀⠄⠀⠄⠨⢛⠻⠛⢛⠻⠀⠠⠀⠠⠀⠄⠠⠀⠄⠠⠀⠄⠠⠀⠄⠠⠀⠄⠠⠀⠄⠠⠀⠄⠄⠄⠀⠀⠀⠀⠀⠀⠀⠀⠀⠀⠀⠀⠀
⠀⠀⠀⠀⠀⠀⠀⢀⣴⣿⡿⡿⢿⠿⡿⠿⡿⠿⡿⠿⡿⠿⡿⠿⡿⠿⡿⢿⠿⢿⠿⢿⠿⡿⠿⣟⢿⢟⢿⢟⢿⠿⡿⠿⡿⠿⡿⠿⡿⠿⡿⠿⡿⠿⡿⠿⡿⠿⡿⠿⡿⠿⡿⢿⠿⡿⣿⣶⣄⠀⠀⠀⠀⠀⠀⠀⠀⠀⠀⠀
⠀⠀⠀⠀⠀⠀⢠⣿⡿⣱⢣⢏⢮⡳⢭⡫⣎⢯⡪⣏⢮⡫⡮⡫⡮⡫⣮⣳⣝⢵⡹⣕⢝⣎⣯⡺⣜⢵⢝⢎⡗⣝⢎⢯⡪⣏⢮⡫⣮⣫⢮⡫⡮⡫⡮⡫⡮⡫⡮⡫⡮⡫⣎⢗⡝⡮⣪⡻⣿⡆⠄⠀⠀⠀⠀⠀⠀⠀⠀⠀
⠀⠀⠀⠀⠀⠐⢸⣿⡽⡸⣕⢽⡱⡭⣣⡳⡕⡧⡳⡕⡧⣳⢹⡪⡮⡳⣹⣽⣾⣿⣿⣿⣻⣿⣿⣿⢿⢮⣿⣿⣿⣾⣽⣿⣿⣾⣻⢽⣻⢿⣕⡕⣗⢝⡎⣗⢝⢮⢎⡗⣝⢮⡪⡧⣳⢹⢜⣎⣿⡇⠄⠀⠀⠀⠀⠀⠀⠀⠀⠀
⠀⠀⠀⠀⠀⠀⠂⢿⣿⣕⡧⡳⣕⢽⡸⣜⢎⡗⣝⢎⡗⣕⢗⢵⢝⢎⡗⣝⢏⢧⡳⡱⡵⡹⡜⣎⢧⢳⡹⡪⣏⢯⡫⣫⡫⣫⢳⢕⣝⢝⢖⣝⢼⡱⣝⢜⣕⢗⢵⢝⣜⢮⢺⢜⡎⣗⣵⣷⣿⠃⠁⠀⠀⠀⠀⠀⠀⠀⠀⠀
⠀⠀⠀⠀⠀⠀⠀⠀⠙⠻⠿⠿⠾⠷⠿⠾⠷⠿⠾⠷⠿⠷⠿⠿⠿⠷⠿⠷⠿⠷⠿⠿⠿⠿⠿⠾⠿⠷⠿⠿⠾⠷⠿⠷⠿⠷⠿⠷⠿⠿⠷⠷⠷⠿⠾⠿⠾⠿⠷⠿⠾⠿⠿⠷⠿⠿⠟⠋⠁⠀⠀⠀⠀⠀⠀⠀⠀⠀⠀⠀
⠀⠀⠀⠀⠀⠀⠀⣀⣀⠀⠁⢁⣁⠁⢁⣁⡁⠁⠁⠁⠁⠁⠁⠁⠁⠁⠁⠁⠁⠁⠁⠅⠁⠁⠁⠁⠁⢁⣁⠁⠁⣁⣁⡁⠁⠁⠁⠁⠁⢁⣁⣁⣁⠁⠁⠁⣁⡁⠁⠁⠁⠁⠁⣁⡁⠁⠀⠀⠀⠀⠀⠀⠀⠀⠀⠀⠀⠀⠀⠀
⠀⠀⠀⠀⠀⠀⢰⣿⣿⣿⣿⣿⣿⣿⣿⣿⣿⣿⣿⣿⣿⣿⣿⣿⣿⣿⣿⣿⣿⣿⣿⣿⣿⣿⣿⣿⣿⣿⣿⣿⣿⣻⣿⣿⣿⣿⣿⣿⣿⣿⣿⣿⣿⣿⣿⣿⣿⣿⣿⣿⣿⣿⣿⣿⣿⠀⠀⠀⠀⠀⠀⠀⠀⠀⠀⠀⠀⠀⠀⠀